0 0 0 0 0 0 0 0 0 0 W W W 0 0 W W
0 0 0 0 0 0 0 0 0 0 W W W 0 0 W W
0 0 0 0 0 0 0 0 0 0 W W W 0 0 W W
0 0 0 0 0 0 0 0 0 0 0 2 0 0 0 W W
0 0 0 0 0 0 0 0 0 0 0 0 0 0 0 W W
0 0 0 0 0 0 0 0 0 0 0 0 0 0 0 W W
0 0 0 0 0 0 0 0 0 0 0 0 0 0 0 W W
0 0 0 0 5 W W W W W W W W W W W W
0 0 0 0 0 0 0 0 0 0 0 0 0 0 0 W W
0 0 0 0 0 0 0 0 0 0 0 0 0 0 0 0 W
0 0 0 0 0 0 0 0 0 0 0 0 0 0 G 0 W
0 0 0 0 0 0 0 0 0 0 0 0 0 0 0 0 W
0 0 0 0 0 0 0 0 0 0 0 0 0 0 0 W W
W W W W W W W W W W W W W W W W W
13.5 0