W W W W W 0 0 0 0 0 0 0 0 0 0 0 0 0 0 0 0 0 0
W 0 0 3 W 0 0 0 0 0 0 0 0 0 0 0 0 0 0 0 0 0 0
W 0 0 0 W W W W W W W W W W W W W W W W W W W
W 0 0 0 0 0 0 0 0 0 0 0 0 0 0 0 0 0 0 0 0 0 W
W W W W W W W W W W W W W W W W W W W W W 0 W
W 3 3 3 3 3 3 3 3 3 3 3 3 3 3 3 3 3 3 3 W 0 W
W W W W W W W W W W W W W W W W W W W W 0 0 W
W 0 0 0 0 0 0 0 0 0 0 0 0 0 0 0 0 0 0 0 0 0 W
W 0 0 0 W W W W W W W W W W W W W W W W W W W
W 0 0 0 0 0 0 0 0 0 0 0 0 0 0 0 0 0 0 0 0 3 W
W 0 0 0 5 5 0 0 0 0 0 0 0 0 0 0 0 0 0 0 0 0 W
W 0 0 0 5 5 0 0 0 0 0 0 0 0 0 0 0 0 W W 0 0 W
W 0 0 0 0 0 0 0 0 0 0 0 0 0 0 0 0 0 0 W 0 0 W
W 0 0 0 0 0 0 0 0 0 0 0 0 0 0 0 0 0 0 W 0 0 W
W W W W W W W W W W W W W W W W W W W W 0 0 W
W 3 3 3 3 3 3 3 3 3 3 3 3 3 3 3 3 3 5 W 0 0 W
W 0 G 0 W W W W W W W W W W W W W W W 0 0 0 W
W 0 0 0 0 0 0 0 0 0 0 0 0 0 0 0 0 0 0 0 0 0 W
W W W W W W W W W W W W W W W W W W W W W W W
1.5 1.5